5 5
0 0 0 0 0
0 2 2 0 0
0 0 2 0 0
1 2 4 2 0
0 2 0 0 0